й=y
ц=c
у=u
к=k
е=e
н=n
г=g
ш=sh
щ=shh
з=z
х=h
ъ=''
ё=yo
ф=f
ы=y
в=v
а=a
п=p
р=r
о=o
л=l
д=d
ж=zh
э=eh
я=ya
ч=ch
с=s
м=m
и=i
т=t
б=b
ю=yu
 = 